f///////////////f///////////////f///////////////f///////////////f///////////////f///////////////f///////////////f///////////////f///////////////f///////////////f///////////////f///////////////f///////////////f///////////////f///////////////f///////////////f///////////////f///////////////
|..............................................................................................................................................................................................................................................................................................|
/...................................................................F..................................................................................................................F......................................................................................................./
/.............................................................................................................................F..........................................................................................................................F...................................../
/.............................................................................................................................................F.........................................................F.............................F......................................................../
/..................................................................................................F..............................................................F................................................................................................................F.........../
/....................................................................F...........................................................................................................................................F............................................................................./
/..............................................................................................................F.........................F................t.......................F.............................................F.................F.............F............................../
/.................................................................F..................t........F................................................................................................................................................................................................/
/.........................................................................................................................................................pUp..............pUp...............pUp........................pUp................pUp.......................pUp......................./
/....................................................pUp..................pUp............pUp...........pUp..........pUp............pUp.....................p................p.................p..........................p..................p.........................p......................../
/.....................................................p.....t..............p..............p.............p............p..............p..........w............................w............................................3..................LR........................3......................../
/.........................................................................................w..........................p........................./...........L................/.................L........................../..................LR......................../......................../
|......................................l...l...l........................................../..........................p..............L........../............................/.................L........................../..................pp......................../........................|
/........................................................................................./..................pUp.....p........................./...........L................/.................p................................................................................................/
/........................................................................................./...................p......p..............L......l...l....................l.......l.................................e....e............l...l........................................................../
/.............................................................................3...........L................l......l.....l.........................................................................................................................................l....l...l.................../
/..........................................................................ppp/...........L...........................................................3........L.............................................................................................................................../
/.......................................3ppppppppppp.................S...ppppp/.............................................................S........./........L.............................................................................................................................../
/......................................./..........................ppppppppppppppppp......................................................ppppppp...../................................S..............3.................3.......................S............................................../
/......................................./.............................................................................................................ppppppp......................ppppppppp........../......e..e.e...../.................ppppppppppppp......................................../
/.............ppppppp.............Lpppppp....................................................ppppppppp........................ppppppp................................................................./................./....................................................................../
/.....................................................................................................................................................................................................ppppppppppppppppppp....................................................................../
/...t.......................................................................................................................................................................................................................................................................................v../
/...c.................................................................................................................................................................................................................................................................................ppppppppp/
f///////////////f///////////////d///////////////d///////////////d///////////////d///////////////d///////////////d///////////////d///////////////d///////////////d///////////////d///////////////d///////////////d///////////////d///////////////d///////////////d///////////////d///////////////
f///////////////f///////////////f///////////////f///////////////f///////////////f///////////////f///////////////f///////////////f///////////////f///////////////f///////////////f///////////////f///////////////f///////////////f///////////////f///////////////f///////////////f///////////////

underwater.wpn
underwater.jpk
level2
darkblue_tile.png
level3.snd
