f//////l////////
|...............
/...............
/...............
/...............
/...............
/...............
/...............
/...............
/...c...........
f///////////////

default.wpn
default.jpk
